11111111111
1C0E00P1111
10000C00001
1C000100001
11111111111
