1111111111111111111111111111111111111111
1C0E00010P000000000000000000000000001111
10000C0000100000000000000000000000000001
1C0001000010000100000000000C000000000001
1111111C0000000C100000100000000001000001
1111111111111111111111111111111111111111
