11111111111111
1C0E00010P0001
10000001000C01
1000C1000C0011
11111111000001
11111111111111
