11111111111111
1CPE00010P0001
10000001000C01
100PC1000C0011
11101111000001
11111111111111
