11111111111111
1CPE00010P0001
100Y0001000C01
100PC10Y0C0011
11101111000001
11111111111111
